0  0  26  0  0 0  0  0  0  0  0  0  0  0  0  0  0  0  0  0  0  0  0  0  0  0  0  0  0  0  0  0
0  0  0  0  0  0  0  0  0  0  0  0  0  0  0  0  0  0  0  0  0  0  0  0  0  0  0  0  0  0  0  0
0  0  23 0  0  0  0  0  0  0  0  0  0  0  0  0  0  0  0  0  0  0  0  0  0  0  0  0  0  0  0  0
0  14 15 16  0  0  0  0  0  0  0  0  0  0  0  0  0  0 12 0  0  0  0  0  0  0  0  0  0  0  0  0
0  0  0  0  0  0  0  0  0  0  0  0  0  0  0  0  14 15 16 0  0  0  0  0  0  0  0  0  0  0  0  0
0  0  0  0  0  0  0  0  0  0  0  0  0  0  0  0  0  0  0  0  0  0  0  0  0  0  0  0  0  0  0  0
0  0  0  0  0  14 15 16 0  0  0  0  0  0  0  0  0  0  0  0  0  0  0  0  0  12 0  0  0  0  42 0
0  0  0  0  0  0  0  0  0  0  0  14 15 16 0  0  0  0  0  0  0  0  0  0  0  14 15 15 15 15 16 0
0  0  0  0  0  0  0  0  0  0  0  0  0  0  0  0  0  0  0  0  0  0  0  0  0  0  0  0  0  0  0  0
0  0  0  0  0  0  0  0  0  0  0  0  0  0  0  0  0  0  0  0  0  0  0  0  0  0  0  0  0  0  0  0
0  0  0  0  0  0  0  0  0  0  0  0  0  0  0  0  0  0  0  0  0  0  0  0  0  0  0  0  0  0  0  0
0  0  0  0  0  0  0  0  0  0  0  0  0  0  0  0  0  0  0  0  0  0  0  0  0  0  0  0  0  0  0  0
0  0  0  0  0  0  0  0  0  0  0  0  0  0  0  0  0  0  0  0  0  0  0  0  0  0  0  0  0  0  0  0
0  0  0  0  0  0  0  0  0  0  0  0  0  0  0  0  0  0  0  0  0  0  0  0  0  0  0  0  0  0  0  0
0  0  0  0  0  0  0  0  0  0  0  0  0  0  0  0  0  36 35 37 0  0  0  0  0  0  0  0  0  0  0  0
0  0  0  0  0  0  0  0  0  0  0  0  0  0  0  0  36 38 35 38 37 0  0  0  0  0  0  0  0  0  0  0
0  0  0  0  0  0  0  0  0  0  0  36 35 37 0  0  0  0  34 0  0  0  0  0  0  0  0  0  0  0  0  0
40 0  28 0  0  0  0  0  0  0  36 38 35 38 37 0  0  0  34 0  0  0  0  0  0  0  0  0  0  0  0  0
41 0  43 0  12 0  0  0  0  0  0  0  34 0  0  0  0  0  34 0  0  0  0  0  0  0  0  0  0  0  0  0
14 15 15 15 16 0  0  0  0  0  0  0  34 0  0  0  0  0  34 0  0  0  0  0  0  0  0  36 35 37 0  0
0  0  0  0  0  0  0  0  0  0  0  0  34 0  0  0  0  0  33 0  0  0  0  0  0  0  36 38 35 38 37 0
0  0  0  0  0  0  0  0  0  0  0  0  33 21 0  0  0  14 15 16 0  0  0  0  0  0  0  26 34 26 0  0
0  0  0  0  0  0  0  0  0  0  0  14 15 16 0  0  0  0  0  0  0  0  0  0  0  0  0  0  34 0  0  0
0  0  0  0  0  0  0  0  0  0  0  0  0  0  0  0  0  0  0  0  0  0  0  0  0  0  0  0  34 0  0  0
0  0  0  0  0  0  0  0  0  0  0  0  0  0  0  0  0  0  0  0  0  0  0  0  0  0  0  0  33 0  0  0
0  0  0  0  0  0  0  0  0  0  0  0  0  0  0  0  0  0  0  0  0  0  0  0  0  0  0  0  54 0  0  0
0  0  0  0  0  0  0  0  0  0  0  0  0  0  0  0  0  0  0  0  0  0  0  0  0  0  0  0  0  0  0  0
0  0  0  0  0  0  0  0  0  0  0  0  0  0  0  0  0  0  0  0  0  0  0  0  0  0  0  0  0  0  0  0
0  0  0  0  0  0  0  0  0  0  0  0  0  0  0  0  0  0  0  0  0  0  0  0  0  0  0  0  0  0  0  0
0  0  0  0  0  0  0  0  0  0  0  0  0  0  0  0  0  0  0  0  0  0  0  0  0  0  0  0  0  0  0  0
18 18 18 18 18 18 18 18 18 18 18 18 18 18 39 18 39 18 39 18 18 18 18 18 18 18 18 18 18 18 18 18