0  0  0  0  0  0  0  0  0  0  0  0  0  0  0  0  0  0  0  17 0  0  0  0  0  0  0  0  0  0  0  0
0  0  0  0  0  0  0  0  0  0  0  0  0  0  0  0  0  0  0  17 0  0  0  0  0  0  0  0  0  0  0  0
0  0  0  0  0  0  0  0  0  0  0  0  0  0  0  0  0  0  0  19 0  0  0  0  0  0  0  0  0  0  0  0
0  0  0  0  0  14 16 0  0  0  0  0  0  0  0  0  0  0  0  20 0  0  0  0  0  0  0  0  0  0  0  0
0  0  0  0  0  0  0  0  0  0  0  0  0  0  0  0  0  0  0  17 0  0  0  0  0  0  0  0  0  0  0  0
0  0  0  0  0  0  0  0  0  0  14 16 0  0  0  0  0  0  0  17 23 24 0  0  0  0  0  0  0  0  0  0
0  0  14 16 0  0  0  0  0  0  0  0  0  0  0  0  0  0  0  17 0  0  0  0  0  0  0  0  0  0  0  0
0  0  0  0  0  0  0  0  0  0  0  0  0  0  14 16 0  0  24 17 0  0  0  0  0  0  0  0  0  0  0  0
0  0  0  0  0  14 16 0  0  0  0  0  0  0  0  0  0  0  0  17 24 0  0  0  0  0  0  0  0  0  0  0
0  0  0  0  0  0  0  0  0  0  0  0  0  0  0  0  0  0  0  17 0  0  0  0  0  0  0  0  0  0  0  0
0  0  0  0  0  0  0  0  14 16 0  0  0  0  0  0  0  24 23 17 0  0  0  0  0  0  0  0  0  0  0  0
0  0  0  0  0  0  0  0  0  0  0  0  0  0  0  0  0  0  0  17 0  0  0  0  0  0  0  0  0  0  0  0
0  0  0  0  21 0  0  0  0  0  0  0  0  0  0  0  0  0  0  17 0  0  0  0  0  0  0  0  0  0  0  0
0  0  0  0  3  5  0  0  0  0  0  0  0  0  0  0  0  0  0  17 23 24 0  0  0  0  0  0  0  0  0  0
0  0  0  0  9  11 0  0  0  0  0  0  0  0  0  0  0  0  0  17 0  0  0  0  0  0  0  0  0  0  0  0
0  0  0  0  0  0  0  0  0  0  0  0  0  0  0  0  0  0  24 17 0  0  0  0  0  0  0  0  0  0  0  0
0  0  0  0  0  0  0  0  0  12 0  0  0  0  0  0  0  0  0  17 0  0  0  0  0  0  0  0  0  0  0  0
14 15 16 0  0  0  0  0  0  3  5  0  0  0  0  0  0  0  0  17 0  0  0  0  18 0  0  0  0  0  0  0
0  26 0  0  0  0  0  0  0  9  11 0  0  0  0  0  0  0  0  17 0  0  0  14 15 16 0  0  0  0  0  0
0  0  0  0  0  0  0  0  0  0  0  0  0  0  0  0  0  0  0  17 0  0  0  0  0  0  0  0  0  0  0  0
0  0  0  0  0  0  0  0  0  0  0  0  0  0  0  0  0  0  14 15 16 0  0  0  0  0  0  0  0  0  0  0
0  0  0  0  0  0  0  0  0  0  0  0  0  0  0  0  0  0  0  0  0  0  0  0  0  0  0  0  0  0  28 0
0  0  0  0  18 0  0  12 0  0  0  0  0  0  0  0  0  0  0  0  0  0  0  0  0  0  0  0  18 0  27 0
0  0  0  0  29 1  1  1  0  0  0  0  0  0  0  0  0  0  0  0  0  0  0  0  0  0  0  0  29 1  1  1
1  1  1  1  2  2  2  2  0  0  0  0  0  0  0  0  0  0  0  0  0  0  0  0  0  0  0  0  2  2  2  2
2  2  2  2  2  2  2  2  22 0  0  0  0  0  0  0  0  0  0  0  0  0  0  0  0  0  0  0  2  2  2  2
2  2  2  2  2  2  2  2  24 0  0  0  0  0  0  0  0  0  0  0  0  0  0  0  0  0  0  0  2  2  2  2
2  2  2  2  2  2  2  25 0  0  0  0  0  0  0  0  0  0  0  0  0  0  0  0  0  0  0  0  2  2  2  2
2  2  2  2  2  2  2  2  0  18 0  0  0  0  0  0  0  0  0  0  0  0  0  0  0  0  0  0  2  2  2  2
2  2  2  2  2  2  2  2  0  14 16 0  0  0  0  0  0  0  0  0  0  0  0  0  0  0  0  0  2  2  2  2
2  2  2  2  2  2  2  2  18 18 18 18 18 18 18 18 18 18 18 18 18 18 18 18 18 18 18 18 2  2  2  2